11111111111111111111111111
1E100000000000000000000001
10110000000001000000000001
10000000100NNNN00000000001
1000000000000000P000000001
10000000000000000000000001
11111110000000000000000001
10000000000000111111000001
10000000000000000C00000001
11111111111111111111111111