11111111111111111111111
101000N00000110C1000CC1
10111110000010000000111
10000000000011111100001
1011111000000000000CC11
101000N0000N00000111001
10111111000001111111101
10000C0101000000CC01111
1000111101000011110CC01
10CC00C1010000100000001
11111111011111100000001
10C00000000000000000001
1P00C1111000000N00000E1
11111111111111111111111