111111111
1111111E1
1P00C01N1
100000001
100000001
111111111