11111111111111
1C0C00000000E1
111111111C0001
1C000000000001
10000000000001
10P00000000001
1000C0000C0001
1000000C000011
11111111111111